X X X X X X X X X X X X X X X X X X X X X X X X X X X X
X X X X X X X X X X X X X X X X X X X X X X X X X X X X
X X X X X X X X X X X X X X X X X X X X X X X X X X X X
6 4 4 4 4 4 4 4 4 4 4 4 4 5 6 4 4 4 4 4 4 4 4 4 4 4 4 5
3 2 0 0 0 0 1 0 0 0 0 0 1 3 3 1 0 0 0 0 0 1 0 0 0 0 2 3
3 0 6 4 4 5 0 6 4 4 4 5 0 7 8 0 6 4 4 4 5 0 6 4 4 5 0 3
3 0 3 X X 3 0 3 X X X 3 1 0 0 1 3 X X X 3 0 3 X X 3 0 3
3 0 7 4 4 8 0 7 4 4 4 8 0 6 5 0 7 4 4 4 8 0 7 4 4 8 0 3
3 1 0 0 0 0 1 0 0 1 0 0 1 3 3 1 0 0 1 0 0 1 0 0 0 0 1 3
3 0 6 4 4 5 0 6 5 0 6 4 4 8 7 4 4 5 0 6 5 0 6 4 4 5 0 3
3 0 7 4 4 8 0 3 3 0 7 4 4 5 6 4 4 8 0 3 3 0 7 4 4 8 0 3
3 1 0 0 0 0 1 3 3 1 0 0 1 3 3 1 0 0 1 3 3 1 0 0 0 0 1 3
7 4 4 4 4 5 0 3 7 4 4 5 0 3 3 0 6 4 4 8 3 0 6 4 4 4 4 8
X X X X X 3 0 7 4 4 4 8 0 7 8 0 7 4 4 4 8 0 3 X X X X X
X X X X X 3 1 0 1 n - - n - - n - - n 1 0 1 3 X X X X X
X X X X X 3 0 6 5 - 6 4 4 9 9 4 4 5 - 6 5 0 3 X X X X X
4 4 4 4 4 8 0 3 3 - 3 X X X X X X 3 - 3 3 0 7 4 4 4 4 4
n n - - - - n 3 3 n 3 X X X X X X 3 n 3 3 n - - - - n n
5 1 6 4 4 5 0 3 3 - 3 X X X X X X 3 - 3 3 0 6 4 4 5 1 6
3 0 3 X X 3 0 3 3 - 7 4 4 4 4 4 4 8 - 3 3 0 3 X X 3 0 3
3 0 3 X X 3 0 3 3 n - - - - - - - - n 3 3 0 3 X X 3 0 3
3 0 3 X X 3 0 3 3 0 6 4 4 4 4 4 4 5 0 3 3 0 3 X X 3 0 3
3 0 7 4 4 8 0 7 8 0 7 4 4 4 4 4 4 8 0 7 8 0 7 4 4 8 0 3
3 1 0 0 0 0 1 0 0 1 0 0 1 0 0 1 0 0 1 0 0 1 0 0 0 0 1 3
3 0 6 4 4 5 0 6 4 4 4 5 0 6 5 0 6 4 4 4 5 0 6 4 4 5 0 3
3 0 7 4 5 3 0 7 4 4 4 8 0 3 3 0 7 4 4 4 8 0 3 6 4 8 0 3
3 1 0 1 3 3 1 0 0 1 0 0 1 3 3 1 0 0 1 0 0 1 3 3 1 0 1 3
7 4 5 0 3 3 0 6 5 0 6 4 4 8 7 4 4 5 0 6 5 0 3 3 0 6 4 8
6 4 8 0 7 8 0 3 3 0 7 4 4 5 6 4 4 8 0 3 3 0 7 8 0 7 4 5
3 1 0 1 0 0 1 3 3 1 0 0 1 3 3 1 0 0 1 3 3 1 0 0 1 0 1 3
3 0 6 4 4 5 0 3 7 4 4 5 0 3 3 0 6 4 4 8 3 0 6 4 4 5 0 3
3 0 7 4 4 8 0 7 4 4 4 8 0 7 8 0 7 4 4 4 8 0 7 4 4 8 0 3
3 2 0 0 0 0 1 0 0 0 0 0 1 0 0 1 0 0 0 0 0 1 0 0 0 0 2 3
7 4 4 4 4 4 4 4 4 4 4 4 4 4 4 4 4 4 4 4 4 4 4 4 4 4 4 8
X X X X X X X X X X X X X X X X X X X X X X X X X X X X
X X X X X X X X X X X X X X X X X X X X X X X X X X X X